##############
#....~~~~~~..#
#....~~~~~~..#
#....######..#
#....#....#..#
#.......@.#..#
#.........#..#
##############